ABY = "countries/Abyss.txt"
FON = "countries/Fontaine.txt"
INA = "countries/Inazuma.txt"
MOT = "countries/Mondstadt.txt"
NAT = "countries/Natlan.txt"
PRI = "countries/Principles.txt"
SNE = "countries/Snezhnaya.txt"
SUM = "countries/Sumeru.txt"
SAN = "countries/Sangonomiya.txt"
DRA = "countries/Dragonspine.txt"
RAG = "countries/Ragnvindr.txt"
LAW = "countries/Lawrence.txt"
GUN = "countries/Gunnhildr.txt"
FAV = "countries/Favonius.txt"
SPI = "countries/Springvale.txt"
DVA = "countries/Dvalin.txt"
ANR = "countries/Andrius.txt"
ASA = "countries/ASA.txt"
TSU = "countries/TSU.txt"
VAN = "countries/VAN.txt"
SGD = "countries/SGD.txt"
SFG = "countries/SFG.txt"
SGS = "countries/SGS.txt"
SDH = "countries/SDH.txt"
SKD = "countries/SKD.txt"
SGC = "countries/SGC.txt"
HIL = "countries/HIL.txt"
HIP = "countries/HIP.txt"
ZZZ = "countries/ZZZ.txt"
SFS = "countries/Snezhnaya Fatui Skirmisher.txt"
SDS = "countries/South Dominion Of Snezhnaya.txt"
MHL = "countries/Mita Hilichurls.txt"
VLM = "countries/Veluriyam Mirage.txt"
KNA = "countries/kynnast.txt"
ZZZ = "countries/kynnast.txt"
HSR = "countries/HRS.txt"
NDK = "countries/NDK.txt"

#璃月七星DOGE
LYY = "countries/Liyue.txt"
GYP = "countries/GYP.txt"
SHP = "countries/SHP.txt"
KQP = "countries/KQP.txt"
BRF = "countries/BRF.txt"
CYG = "countries/CYG.txt"
YLH = "countries/YLH.txt"